year,week,date,new,total,source
2020,8,2020-02-23,0,0,fhi:git
2020,9,2020-03-01,0,0,fhi:git
2020,10,2020-03-08,0,0,fhi:git
2020,11,2020-03-15,4,4,fhi:git
2020,12,2020-03-22,9,13,fhi:git
2020,13,2020-03-29,23,36,fhi:git
2020,14,2020-04-05,44,80,fhi:git
2020,15,2020-04-12,60,140,fhi:git
2020,16,2020-04-19,46,186,fhi:git
2020,17,2020-04-26,23,209,fhi:git
2020,18,2020-05-03,11,220,fhi:git
2020,19,2020-05-10,11,231,fhi:git
2020,20,2020-05-17,5,236,fhi:git
2020,21,2020-05-24,2,238,fhi:git
2020,22,2020-05-31,6,244,fhi:git
2020,23,2020-06-07,1,245,fhi:git
2020,24,2020-06-14,2,247,fhi:git
2020,25,2020-06-21,5,252,fhi:git
2020,26,2020-06-28,3,255,fhi:git
2020,27,2020-07-05,1,256,fhi:git
2020,28,2020-07-12,1,257,fhi:git
2020,29,2020-07-19,1,258,fhi:git
2020,30,2020-07-26,0,258,fhi:git
2020,31,2020-08-02,2,260,fhi:git
2020,32,2020-08-09,0,260,fhi:git
2020,33,2020-08-16,3,263,fhi:git
2020,34,2020-08-23,1,264,fhi:git
2020,35,2020-08-30,0,264,fhi:git
2020,36,2020-09-06,1,265,fhi:git
2020,37,2020-09-13,2,267,fhi:git
2020,38,2020-09-20,3,270,fhi:git
2020,39,2020-09-27,5,275,fhi:git
2020,40,2020-10-04,2,277,fhi:git
2020,41,2020-10-11,2,279,fhi:git
2020,42,2020-10-18,1,280,fhi:git
2020,43,2020-10-25,3,283,fhi:git
2020,44,2020-11-01,2,285,fhi:git
2020,45,2020-11-08,10,295,fhi:git
2020,46,2020-11-15,10,305,fhi:git
2020,47,2020-11-22,21,326,fhi:git
2020,48,2020-11-29,31,357,fhi:git
2020,49,2020-12-06,23,380,fhi:git
2020,50,2020-12-13,25,405,fhi:git
2020,51,2020-12-20,17,422,fhi:git
2020,52,2020-12-27,25,447,fhi:git
2020,53,2021-01-03,30,477,fhi:git
2021,1,2021-01-10,37,514,fhi:git
2021,2,2021-01-17,34,548,fhi:git
2021,3,2021-01-24,20,568,fhi:git
2021,4,2021-01-31,24,592,fhi:git
2021,5,2021-02-07,17,609,fhi:git
2021,6,2021-02-14,18,627,fhi:git
2021,7,2021-02-21,11,638,fhi:git
2021,8,2021-02-28,8,646,fhi:git
2021,9,2021-03-07,6,652,fhi:git
2021,10,2021-03-14,10,662,fhi:git
2021,11,2021-03-21,13,675,fhi:git
2021,12,2021-03-28,18,693,fhi:git
2021,13,2021-04-04,18,711,fhi:git
2021,14,2021-04-11,24,735,fhi:git
2021,15,2021-04-18,24,759,fhi:git
2021,16,2021-04-25,13,772,fhi:git
2021,17,2021-05-02,16,788,fhi:git
2021,18,2021-05-09,5,793,fhi:git
2021,19,2021-05-16,8,801,fhi:git
2021,20,2021-05-23,3,804,fhi:git
2021,21,2021-05-30,2,806,fhi:git
2021,22,2021-06-06,4,810,fhi:git
2021,23,2021-06-13,1,811,fhi:git
2021,24,2021-06-20,1,812,fhi:git
2021,25,2021-06-27,3,815,fhi:git
2021,26,2021-07-04,2,817,fhi:git
2021,27,2021-07-11,0,817,fhi:git
2021,28,2021-07-18,2,819,fhi:git
2021,29,2021-07-25,1,820,fhi:git
2021,30,2021-08-01,4,824,fhi:git
2021,31,2021-08-08,4,828,fhi:git
2021,32,2021-08-15,5,833,fhi:git
2021,33,2021-08-22,4,837,fhi:git
2021,34,2021-08-29,10,847,fhi:git
2021,35,2021-09-05,6,853,fhi:git
2021,36,2021-09-12,18,871,fhi:git
2021,37,2021-09-19,16,887,fhi:git
2021,38,2021-09-26,13,900,fhi:git
2021,39,2021-10-03,9,909,fhi:git
2021,40,2021-10-10,10,919,fhi:git
2021,41,2021-10-17,10,929,fhi:git
2021,42,2021-10-24,14,943,fhi:git
2021,43,2021-10-31,20,963,fhi:git
2021,44,2021-11-07,38,1001,fhi:git
2021,45,2021-11-14,50,1051,fhi:git
2021,46,2021-11-21,55,1106,fhi:git
2021,47,2021-11-28,54,1160,fhi:git
2021,48,2021-12-05,57,1217,fhi:git
2021,49,2021-12-12,54,1271,fhi:git
2021,50,2021-12-19,67,1338,fhi:git
2021,51,2021-12-26,56,1394,fhi:git
2021,52,2022-01-02,48,1442,fhi:git
2022,1,2022-01-09,30,1472,fhi:git
2022,2,2022-01-16,29,1501,fhi:git
2022,3,2022-01-23,29,1530,fhi:git
2022,4,2022-01-30,32,1562,fhi:git
2022,5,2022-02-06,54,1616,fhi:git
2022,6,2022-02-13,61,1677,fhi:git
2022,7,2022-02-20,84,1761,fhi:git
2022,8,2022-02-27,114,1875,fhi:git
2022,9,2022-03-06,156,2031,fhi:git
2022,10,2022-03-13,186,2217,fhi:git
2022,11,2022-03-20,200,2417,fhi:git
2022,12,2022-03-27,173,2590,fhi:git
2022,13,2022-04-03,127,2717,fhi:git
2022,14,2022-04-10,125,2842,fhi:git
2022,15,2022-04-17,80,2922,fhi:git
2022,16,2022-04-24,60,2982,fhi:git
2022,17,2022-05-01,71,3053,fhi:git
2022,18,2022-05-08,45,3098,fhi:git
2022,19,2022-05-15,26,3124,fhi:git
2022,20,2022-05-22,38,3162,fhi:git
2022,21,2022-05-29,36,3198,fhi:git
2022,22,2022-06-05,38,3236,fhi:git
2022,23,2022-06-12,33,3269,fhi:git
2022,24,2022-06-19,37,3306,fhi:git
2022,25,2022-06-26,65,3371,fhi:git
2022,26,2022-07-03,71,3442,fhi:git
2022,27,2022-07-10,94,3536,fhi:git
2022,28,2022-07-17,100,3636,fhi:git
2022,29,2022-07-24,89,3725,fhi:git
2022,30,2022-07-31,72,3797,fhi:git
2022,31,2022-08-07,63,3860,fhi:git
2022,32,2022-08-14,57,3917,fhi:git
2022,33,2022-08-21,55,3972,fhi:git
2022,34,2022-08-28,31,4003,fhi:git
2022,35,2022-09-04,25,4028,fhi:git
2022,36,2022-09-11,36,4064,fhi:git
2022,37,2022-09-18,23,4087,fhi:git
2022,38,2022-09-25,27,4114,fhi:git
2022,39,2022-10-02,23,4137,fhi:git
2022,40,2022-10-09,31,4168,fhi:git
2022,41,2022-10-16,29,4197,fhi:git
2022,42,2022-10-23,23,4220,fhi:git
2022,43,2022-10-30,22,4242,fhi:git
2022,44,2022-11-06,44,4286,fhi:git
2022,45,2022-11-13,0,4286,fhi:git
