date,new_downloads,total_downloads,new_reported,total_reported,source
2020-12-21,117700,117700,23,23,fhi:web
2020-12-22,41000,158700,18,41,fhi:web
2020-12-23,15600,174300,12,53,fhi:web
2020-12-24,9500,183800,19,72,fhi:web
2020-12-25,10900,194700,10,82,fhi:web
2020-12-26,12500,207200,8,90,fhi:web
2020-12-27,10200,217400,14,104,fhi:web
2020-12-28,13800,231200,21,125,fhi:web
2020-12-29,10500,241700,22,147,fhi:web
2020-12-30,7300,249000,26,173,fhi:web
2020-12-31,6800,255800,13,186,fhi:web
2021-01-01,3200,259000,17,203,fhi:web
2021-01-02,3900,262900,11,214,fhi:web
2021-01-03,82100,345000,36,250,fhi:web
2021-01-04,21300,366300,17,267,fhi:web
2021-01-05,8300,374600,25,292,fhi:web
2021-01-06,27400,402000,35,327,fhi:web
2021-01-07,6000,408000,31,358,fhi:web
2021-01-08,4600,412600,21,379,fhi:web
2021-01-09,3300,415900,15,394,fhi:web
2021-01-10,3700,419600,19,413,fhi:web
2021-01-11,3400,423000,8,421,fhi:web
2021-01-12,2200,425200,18,439,fhi:web
2021-01-13,10100,435300,29,468,fhi:web
2021-01-14,2700,438000,17,485,fhi:web
2021-01-15,1800,439800,15,500,fhi:web
2021-01-16,1300,441100,8,508,fhi:web
2021-01-17,19700,460800,10,518,fhi:web
2021-01-18,4400,465200,5,523,fhi:web
2021-01-19,3000,468200,7,530,fhi:web
2021-01-20,3600,471800,10,540,fhi:web
2021-01-21,2500,474300,16,556,fhi:web
2021-01-22,3200,477500,11,567,fhi:web
2021-01-23,10600,488100,8,575,fhi:web
2021-01-24,55300,543400,27,602,fhi:web
2021-01-25,18600,562000,13,615,fhi:web
2021-01-26,96300,658300,40,655,fhi:web
2021-01-27,17400,675700,19,674,fhi:web
2021-01-28,6700,682400,20,694,fhi:web
2021-01-29,4200,686600,8,702,fhi:web
2021-01-30,3800,690400,19,721,fhi:web
2021-01-31,2000,691400,7,728,fhi:web
2021-02-01,700,692100,13,741,fhi:web
2021-02-02,2500,694600,14,744,fhi:web
2021-02-03,58100,752700,30,785,fhi:web
2021-02-04,54600,807300,33,818,fhi:web
2021-02-05,26200,833500,28,846,fhi:web
2021-02-06,3000,836500,14,860,fhi:web
2021-02-07,9600,846100,2,862,fhi:web
2021-02-08,4800,850900,22,884,fhi:web
2021-02-09,2100,853000,10,894,fhi:web
2021-02-10,1700,854700,10,904,fhi:web
2021-02-11,1600,856300,15,919,fhi:web
2021-02-12,1500,857800,14,933,fhi:web
2021-02-13,400,858200,19,952,fhi:web
2021-02-14,1400,859600,12,964,fhi:web
2021-02-15,1500,861100,16,980,fhi:web
2021-02-16,1300,862400,20,1000,fhi:web
2021-02-17,1900,864300,10,1010,fhi:web
2021-02-18,400,864700,21,1031,fhi:web
2021-02-19,1500,866200,19,1050,fhi:web
2021-02-20,1400,867600,16,1066,fhi:web
2021-02-21,200,867800,1,1067,fhi:web
2021-02-22,1400,869200,7,1074,fhi:web
2021-02-23,1500,870700,26,1100,fhi:web
2021-02-24,400,871100,13,1113,fhi:web
2021-02-25,1500,872600,29,1142,fhi:web
2021-02-26,700,873300,25,1167,fhi:web
2021-02-27,500,873800,18,1185,fhi:web
2021-02-28,4500,878300,16,1201,fhi:web
2021-03-01,600,878900,29,1230,fhi:web
2021-03-02,4000,882900,34,1264,fhi:web
2021-03-03,1700,884600,32,1296,fhi:web
2021-03-04,1600,886200,18,1314,fhi:web
2021-03-05,1400,887600,28,1342,fhi:web
2021-03-06,1400,889000,17,1359,fhi:web
2021-03-07,1400,890400,19,1378,fhi:web
2021-03-08,3100,893500,30,1408,fhi:web
2021-03-09,5700,899200,42,1450,fhi:web
2021-03-10,3000,902200,37,1487,fhi:web
2021-03-11,1900,904100,50,1537,fhi:web
2021-03-12,19600,923700,48,1585,fhi:web
2021-03-13,900,924600,33,1618,fhi:web
2021-03-14,4900,929500,31,1649,fhi:web
2021-03-15,3000,932500,49,1698,fhi:web
2021-03-16,1000,933500,58,1756,fhi:web
2021-03-17,30100,963600,52,1808,fhi:web
2021-03-18,2800,966400,66,1874,fhi:web
2021-03-19,1500,967900,52,1926,fhi:web
2021-03-20,1400,969300,56,1982,fhi:web
2021-03-21,1500,970800,39,2021,fhi:web
2021-03-22,1600,972400,40,2061,fhi:web
2021-03-23,1500,973900,47,2108,fhi:web
2021-03-24,1700,975600,47,2155,fhi:web
2021-03-25,1000,976600,39,2194,fhi:web
2021-03-26,2400,979000,43,2237,fhi:web
2021-03-27,1400,980400,29,2266,fhi:web
2021-03-28,300,980700,41,2307,fhi:web
2021-03-29,1300,982000,21,2328,fhi:web
2021-03-30,200,982200,35,2363,fhi:web
2021-03-31,1400,983600,39,2402,fhi:web
2021-04-01,200,983800,18,2420,fhi:web
2021-04-02,100,983900,33,2453,fhi:web
2021-04-03,1200,985100,33,2486,fhi:web
2021-04-04,200,985300,23,2509,fhi:web
2021-04-05,1200,986500,36,2545,fhi:web
2021-04-06,200,986700,31,2576,fhi:web
2021-04-07,1100,987800,26,2602,fhi:web
2021-04-08,0,987800,31,2633,fhi:web
2021-04-09,500,988300,35,2668,fhi:web
2021-04-10,1200,989500,20,2688,fhi:web
2021-04-11,100,989600,16,2704,fhi:web
2021-04-12,200,989800,19,2723,fhi:web
2021-04-13,5400,995200,27,2750,fhi:web
2021-04-14,400,995600,27,2777,fhi:web
2021-04-15,130,996900,20,2797,fhi:web
2021-04-16,300,997200,26,2823,fhi:web
2021-04-17,1100,998300,16,2839,fhi:web
2021-04-18,100,998400,19,2858,fhi:web
2021-04-19,200,998600,12,2870,fhi:web
2021-04-20,200,998800,22,2892,fhi:web
2021-04-21,200,999000,17,2909,fhi:web
2021-04-22,1400,1000400,20,2929,fhi:web
2021-04-23,300,1000700,9,2938,fhi:web
2021-04-24,100,1000800,13,2951,fhi:web
2021-04-25,1200,1002000,9,2960,fhi:web
2021-04-26,1300,1003300,18,2978,fhi:web
2021-04-27,200,1003005,20,2998,fhi:web
2021-04-28,1200,1004700,9,3007,fhi:web
2021-04-29,100,1004800,18,3025,fhi:web
2021-04-30,200,1005000,6,3031,fhi:web
2021-05-01,1100,1006100,16,3047,fhi:web
2021-05-02,100,1006200,12,3059,fhi:web
2021-05-03,1200,1007400,15,3074,fhi:web
2021-05-04,200,1007600,22,3096,fhi:web
2021-05-05,1100,1008700,29,3125,fhi:web
2021-05-06,200,1008900,29,3154,fhi:web
2021-05-07,1100,1010000,17,3171,fhi:web
2021-05-08,100,1010100,10,3181,fhi:web
2021-05-09,1100,1011200,7,3188,fhi:web
2021-05-10,100,1011300,22,3210,fhi:web
2021-05-11,100,1011400,19,3229,fhi:web
2021-05-12,1200,1012600,22,3251,fhi:web
2021-05-13,100,1012700,11,3262,fhi:web
2021-05-14,200,1012900,11,3273,fhi:web
2021-05-15,100,1013000,22,3295,fhi:web
2021-05-16,1100,1014100,16,3311,fhi:web
2021-05-17,100,1014300,8,3319,fhi:web
2021-05-18,100,1014300,16,3335,fhi:web
2021-05-19,100,1014400,18,3353,fhi:web
2021-05-20,1200,1015600,13,3366,fhi:web
2021-05-21,200,1015800,18,3384,fhi:web
2021-05-22,200,1016000,26,3410,fhi:web
2021-05-23,1300,1017300,39,3449,fhi:web
2021-05-24,200,1017500,16,3465,fhi:web
2021-05-25,1200,1018700,16,3481,fhi:web
2021-05-26,1800,1020500,16,3497,fhi:web
2021-05-27,1200,1021700,17,3514,fhi:web
2021-05-28,200,1021900,20,3534,fhi:web
2021-05-29,100,1022000,14,3548,fhi:web
2021-05-30,100,1022100,9,3557,fhi:web
2021-05-31,200,1022300,11,3568,fhi:web
2021-06-01,200,1022500,16,3584,fhi:web
2021-06-02,2400,1024900,19,3603,fhi:web
2021-06-03,300,1025200,16,3619,fhi:web
2021-06-04,200,1025400,9,3628,fhi:web
2021-06-05,100,1025500,8,3636,fhi:web
2021-06-06,100,1025600,3,3639,fhi:web
2021-06-07,1100,1026700,5,3644,fhi:web
2021-06-08,300,1027000,9,3653,fhi:web
2021-06-09,200,1027200,6,3659,fhi:web
2021-06-10,200,1027400,9,3668,fhi:web
2021-06-11,400,1027800,9,3677,fhi:web
2021-06-12,200,1028000,2,3679,fhi:web
2021-06-13,1100,1029100,3,3682,fhi:web
2021-06-14,400,1029500,8,3690,fhi:web
2021-06-15,200,1029700,6,3696,fhi:web
2021-06-16,200,1029900,13,3709,fhi:web
2021-06-17,200,1030100,4,3713,fhi:web
2021-06-18,200,1030300,11,3724,fhi:web
2021-06-19,200,1030500,9,3733,fhi:web
2021-06-20,1100,1031600,11,3744,fhi:web
2021-06-21,100,1031700,6,3750,fhi:web
2021-06-22,200,1031900,12,3762,fhi:web
2021-06-23,1600,1033500,10,3772,fhi:web
2021-06-24,300,1033800,19,3791,fhi:web
2021-06-25,400,1034200,11,3802,fhi:web
2021-06-26,300,1034500,8,3810,fhi:web
2021-06-27,1100,1035600,3,3813,fhi:web
2021-06-28,1200,1036800,4,3817,fhi:web
2021-06-29,100,1036900,5,3822,fhi:web
2021-06-30,200,1037100,11,3833,fhi:web
2021-07-01,300,1037400,8,3841,fhi:web
2021-07-02,200,1037600,12,3853,fhi:web
2021-07-03,300,1037900,9,3862,fhi:web
2021-07-04,1100,1039000,5,3867,fhi:web
2021-07-05,100,1039100,7,3874,fhi:web
2021-07-06,200,1039300,9,3883,fhi:web
2021-07-07,200,1039500,5,3888,fhi:web
2021-07-08,100,1039600,8,3896,fhi:web
2021-07-09,300,1039900,6,3902,fhi:web
2021-07-10,100,1040000,11,3913,fhi:web
2021-07-11,1100,1041100,5,3918,fhi:web
2021-07-12,100,1041200,1,3919,fhi:web
2021-07-13,100,1041300,4,3923,fhi:web
2021-07-14,200,1041500,5,3928,fhi:web
2021-07-15,100,1041600,0,3932,fhi:web
2021-07-16,200,1041800,9,3941,fhi:web
2021-07-17,100,1041900,11,3952,fhi:web
2021-07-18,1100,1043000,4,3956,fhi:web
2021-07-19,100,1043100,4,3960,fhi:web
2021-07-20,200,1043300,4,3964,fhi:web
2021-07-21,100,1043400,3,3967,fhi:web
2021-07-22,200,1043600,12,3979,fhi:web
2021-07-23,200,1043800,5,3984,fhi:web
2021-07-24,100,1043900,2,3986,fhi:web
2021-07-25,1100,1045000,3,3989,fhi:web
2021-07-26,100,1045100,6,3995,fhi:web
2021-07-27,200,1045300,12,4007,fhi:web
2021-07-28,300,1045600,14,4021,fhi:web
2021-07-29,100,1045700,13,4034,fhi:web
2021-07-30,300,1046000,10,4044,fhi:web
2021-07-31,100,1046100,2,4046,fhi:web
2021-08-01,1100,1047200,8,4054,fhi:web
2021-08-02,100,1047300,4,4058,fhi:web
2021-08-03,200,1047500,5,4063,fhi:web
2021-08-04,100,1047600,9,4072,fhi:web
2021-08-05,200,1047800,14,4086,fhi:web
2021-08-06,200,1048000,13,4099,fhi:web
2021-08-07,100,1048100,9,4108,fhi:web
2021-08-08,100,1048200,10,4118,fhi:web
2021-08-09,1200,1049400,5,4123,fhi:web
2021-08-10,100,1049500,10,4133,fhi:web
2021-08-11,200,1049700,7,4140,fhi:web
2021-08-12,100,1049800,12,4152,fhi:web
2021-08-13,300,1050100,12,4164,fhi:web
2021-08-14,1100,1051200,12,4176,fhi:web
2021-08-15,200,1051400,5,4181,fhi:web
2021-08-16,100,1051500,15,4196,fhi:web
2021-08-17,200,1051700,9,4205,fhi:web
2021-08-18,1200,1052900,10,4215,fhi:web
2021-08-19,200,1053100,8,4223,fhi:web
2021-08-20,100,1053200,16,4239,fhi:web
2021-08-21,100,1053300,17,4256,fhi:web
2021-08-22,100,1053400,4,4260,fhi:web
2021-08-23,200,1053600,15,4275,fhi:web
2021-08-24,200,1053800,25,4300,fhi:web
2021-08-25,1200,1055000,37,4337,fhi:web
2021-08-26,300,1055300,42,4379,fhi:web
2021-08-27,400,1055700,54,4433,fhi:web
2021-08-28,300,1056000,46,4479,fhi:web
2021-08-29,1200,1057200,34,4513,fhi:web
2021-08-30,15400,1072600,88,4601,fhi:web
2021-08-31,2600,1075200,69,4670,fhi:web
2021-09-01,500,1075700,55,4725,fhi:web
2021-09-02,2500,1078200,58,4783,fhi:web
2021-09-03,200,1078400,56,4839,fhi:web
2021-09-04,200,1078600,31,4870,fhi:web
2021-09-05,100,1078700,33,4903,fhi:web
2021-09-06,1200,1079900,20,4923,fhi:web
2021-09-07,200,1080100,42,4965,fhi:web
2021-09-08,200,1080300,47,5012,fhi:web
2021-09-09,200,1080500,20,5032,fhi:web
2021-09-10,200,1080700,28,5060,fhi:web
2021-09-11,100,1080800,18,5078,fhi:web
2021-09-12,1100,1081900,11,5089,fhi:web
2021-09-13,200,1082100,21,5110,fhi:web
2021-09-14,0,1082100,17,5127,fhi:web
2021-09-15,200,1082300,23,5150,fhi:web
2021-09-16,100,1082400,11,5161,fhi:web
2021-09-17,100,1082500,20,5181,fhi:web
2021-09-18,0,1082500,14,5195,fhi:web
2021-09-19,100,1082600,9,5204,fhi:web
2021-09-20,100,1082700,8,5212,fhi:web
2021-09-21,100,1082800,13,5225,fhi:web
2021-09-22,100,1082900,12,5237,fhi:web
2021-09-23,100,1083100,11,5248,fhi:web
2021-09-24,100,1083100,7,5255,fhi:web
2021-09-25,100,1083200,6,5261,fhi:web
2021-09-26,0,1083200,4,5265,fhi:web
2021-09-27,100,1083300,12,5277,fhi:web
2021-09-28,1000,1084300,5,5282,fhi:web
2021-09-29,100,1084400,8,5290,fhi:web
2021-09-30,100,1084500,12,5302,fhi:web
2021-10-01,0,1084500,4,5306,fhi:web
2021-10-02,100,1084600,8,5314,fhi:web
2021-10-03,0,1084600,6,5320,fhi:web
2021-10-04,100,1084700,8,5328,fhi:web
2021-10-05,100,1084800,12,5340,fhi:web
2021-10-06,100,1084900,13,5353,fhi:web
2021-10-07,0,1084900,9,5362,fhi:web
2021-10-08,100,1085000,2,5364,fhi:web
2021-10-09,0,1085000,2,5366,fhi:web
2021-10-10,100,1085100,4,5370,fhi:web
2021-10-11,0,1085100,9,5379,fhi:web
2021-10-12,100,1085200,17,5396,fhi:web
2021-10-13,0,1085200,15,5411,fhi:web
2021-10-14,100,1085300,11,5422,fhi:web
2021-10-15,100,1085400,8,5430,fhi:web
2021-10-16,0,1085400,10,5440,fhi:web
2021-10-17,0,1085400,7,5447,fhi:web
2021-10-18,100,1085500,8,5455,fhi:web
2021-10-19,100,1085600,7,5462,fhi:web
2021-10-20,0,1085600,17,5479,fhi:web
2021-10-21,100,1085700,6,5485,fhi:web
2021-10-22,100,1085800,7,5492,fhi:web
2021-10-23,0,1085800,10,5502,fhi:web
2021-10-24,100,1085900,12,5514,fhi:web
2021-10-25,1100,1087000,7,5521,fhi:web
2021-10-26,0,1087000,16,5537,fhi:web
2021-10-27,100,1087100,22,5559,fhi:web
2021-10-28,100,1087200,18,5577,fhi:web
2021-10-29,100,1087300,24,5601,fhi:web
2021-10-30,0,1087300,16,5617,fhi:web
2021-10-31,100,1087400,13,5630,fhi:web
2021-11-01,100,1087500,20,5650,fhi:web
2021-11-02,100,1087600,14,5664,fhi:web
2021-11-03,0,1087600,28,5692,fhi:web
2021-11-04,100,1087700,33,5725,fhi:web
2021-11-05,100,1087800,32,5757,fhi:web
2021-11-06,100,1087900,34,5791,fhi:web
2021-11-07,0,1087900,23,5814,fhi:web
2021-11-08,100,1088000,29,5843,fhi:web
2021-11-09,1000,1089000,47,5890,fhi:web
2021-11-10,200,1089200,46,5936,fhi:web
2021-11-11,200,1089400,48,5984,fhi:web
2021-11-12,10,1089500,35,6019,fhi:web
2021-11-13,100,1089600,39,6058,fhi:web
2021-11-14,100,1089700,30,6088,fhi:web
2021-11-15,200,1089900,46,6134,fhi:web
2021-11-16,100,1090000,55,6189,fhi:web
2021-11-17,1200,1091200,89,6278,fhi:web
2021-11-18,10,1091300,66,6344,fhi:web
2021-11-19,200,1091500,80,6424,fhi:web
2021-11-20,200,1091700,81,6505,fhi:web
2021-11-21,100,1091800,70,6575,fhi:web
2021-11-22,200,1092000,83,6658,fhi:web
2021-11-23,1100,1093100,75,6733,fhi:web
2021-11-24,300,1093400,95,6828,fhi:web
2021-11-25,200,1093600,130,6958,fhi:web
2021-11-26,100,1093700,113,7071,fhi:web
2021-11-27,100,1093800,85,7156,fhi:web
2021-11-28,200,1094000,77,7233,fhi:web
2021-11-29,200,1094200,98,7331,fhi:web
2021-11-30,1100,1095300,156,7487,fhi:web
2021-12-01,1500,1096800,171,7658,fhi:web
2021-12-02,1900,1098700,233,7891,fhi:web
2021-12-03,1300,1100000,169,8060,fhi:web
2021-12-04,300,1100300,151,8211,fhi:web
2021-12-05,1200,1101500,0,8211,fhi:web
2021-12-06,300,1101800,0,8211,fhi:web
2021-12-07,1200,1103000,135,8346,fhi:web
